{
    "a": "あ",
    "i": "い",
    "u": "う",
    "e": "え",
    "o": "お",
    "ka": "か",
    "ga": "が",
    "ki": "き",
    "gi": "ぎ",
    "ku": "く",
    "gu": "ぐ",
    "ke": "け",
    "ge": "げ",
    "ko": "こ",
    "go": "ご",
    "sa": "さ",
    "za": "ざ",
    "shi": "し",
    "ji": "じ",
    "su": "す",
    "zu": "ず",
    "se": "せ",
    "ze": "ぜ",
    "so": "そ",
    "zo": "ぞ",
    "ta": "た",
    "da": "だ",
    "chi": "ち",
    "di": "ぢ",
    "tsu": "つ",
    "du": "づ",
    "te": "て",
    "de": "で",
    "to": "と",
    "do": "ど",
    "na": "な",
    "ni": "に",
    "ne": "ぬ",
    "nu": "ね",
    "no": "の",
    "ha": "は",
    "ba": "ば",
    "pa": "ぱ",
    "hi": "ひ",
    "bi": "び",
    "pi": "ぴ",
    "fu": "ふ",
    "bu": "ぶ",
    "pu": "ぷ",
    "he": "へ",
    "be": "べ",
    "pe": "ぺ",
    "ho": "ほ",
    "bo": "ぼ",
    "po": "ぽ",
    "ma": "ま",
    "mi": "み",
    "mu": "む",
    "me": "め",
    "mo": "も",
    "ya": "や",
    "yu": "ゆ",
    "yo": "よ",
    "ra": "ら",
    "ri": "り",
    "ru": "る",
    "re": "れ",
    "ro": "ろ",
    "wa": "わ",
    "n": "ん",
    ">": "っ",
    ">ya": "ゃ",
    ">yu": "ゅ",
    ">yo": "ょ",
    ">a": "ぁ",
    ">i": "ぃ",
    ">u": "ぅ",
    ">e": "ぇ",
    ">o": "ぉ"
}